{
  "version": 8,
  "max_level": 100,

  "_comment_xp": "Лв1→2 = 800 XP (~10 побед). Шаг +25 XP за уровень. Итого ~200 475 XP до лв100 ≈ 6 месяцев актив. игры.",
  "xp_to_next": [
    800,  825,  850,  875,  900,  925,  950,  975, 1000, 1025,
   1050, 1075, 1100, 1125, 1150, 1175, 1200, 1225, 1250, 1275,
   1300, 1325, 1350, 1375, 1400, 1425, 1450, 1475, 1500, 1525,
   1550, 1575, 1600, 1625, 1650, 1675, 1700, 1725, 1750, 1775,
   1800, 1825, 1850, 1875, 1900, 1925, 1950, 1975, 2000, 2025,
   2050, 2075, 2100, 2125, 2150, 2175, 2200, 2225, 2250, 2275,
   2300, 2325, 2350, 2375, 2400, 2425, 2450, 2475, 2500, 2525,
   2550, 2575, 2600, 2625, 2650, 2675, 2700, 2725, 2750, 2775,
   2800, 2825, 2850, 2875, 2900, 2925, 2950, 2975, 3000, 3025,
   3050, 3075, 3100, 3125, 3150, 3175, 3200, 3225, 3250
  ],

  "_comment_win": "XP за победу: лв1=80, лв100=180. +1 XP каждый уровень. Последний шаг +2 (178→180).",
  "xp_per_win": [
     80,  81,  82,  83,  84,  85,  86,  87,  88,  89,
     90,  91,  92,  93,  94,  95,  96,  97,  98,  99,
    100, 101, 102, 103, 104, 105, 106, 107, 108, 109,
    110, 111, 112, 113, 114, 115, 116, 117, 118, 119,
    120, 121, 122, 123, 124, 125, 126, 127, 128, 129,
    130, 131, 132, 133, 134, 135, 136, 137, 138, 139,
    140, 141, 142, 143, 144, 145, 146, 147, 148, 149,
    150, 151, 152, 153, 154, 155, 156, 157, 158, 159,
    160, 161, 162, 163, 164, 165, 166, 167, 168, 169,
    170, 171, 172, 173, 174, 175, 176, 177, 178, 180
  ],

  "_comment_stats": "Базово 5 очков за уровень. Каждый 10-й уровень — сигнальный бонус (растёт с уровнем).",
  "stats_on_reach": [
    0,
    5,  5,  5,  5,  5,  5,  5,  5,  5,  8,
    5,  5,  5,  5,  5,  5,  5,  5,  5, 10,
    5,  5,  5,  5,  5,  5,  5,  5,  5, 10,
    5,  5,  5,  5,  5,  5,  5,  5,  5, 12,
    5,  5,  5,  5,  5,  5,  5,  5,  5, 13,
    5,  5,  5,  5,  5,  5,  5,  5,  5, 13,
    5,  5,  5,  5,  5,  5,  5,  5,  5, 15,
    5,  5,  5,  5,  5,  5,  5,  5,  5, 15,
    5,  5,  5,  5,  5,  5,  5,  5,  5, 18,
    5,  5,  5,  5,  5,  5,  5,  5,  5, 20
  ],

  "_comment_gold": "Обычные уровни: 110+10*(lv-1). Сигнальные (×10) — разовый крупный бонус: лв10=800, лв50=3000, лв100=10000.",
  "gold_on_reach": [
    0,
    110, 120, 130, 140, 150, 160, 170, 180, 190,  800,
    210, 220, 230, 240, 250, 260, 270, 280, 290, 1200,
    310, 320, 330, 340, 350, 360, 370, 380, 390, 1700,
    410, 420, 430, 440, 450, 460, 470, 480, 490, 2300,
    510, 520, 530, 540, 550, 560, 570, 580, 590, 3000,
    610, 620, 630, 640, 650, 660, 670, 680, 690, 3800,
    710, 720, 730, 740, 750, 760, 770, 780, 790, 4700,
    810, 820, 830, 840, 850, 860, 870, 880, 890, 5700,
    910, 920, 930, 940, 950, 960, 970, 980, 990, 6800,
   1010,1020,1030,1040,1050,1060,1070,1080,1090,10000
  ],

  "_comment_diamonds": "Алмазы только на сигнальных уровнях (каждые 10). Растут: 2→3→5→5→8→8→10→12→15→25.",
  "diamonds_on_reach": [
    0,
    0, 0, 0, 0, 0, 0, 0, 0, 0,  2,
    0, 0, 0, 0, 0, 0, 0, 0, 0,  3,
    0, 0, 0, 0, 0, 0, 0, 0, 0,  5,
    0, 0, 0, 0, 0, 0, 0, 0, 0,  5,
    0, 0, 0, 0, 0, 0, 0, 0, 0,  8,
    0, 0, 0, 0, 0, 0, 0, 0, 0,  8,
    0, 0, 0, 0, 0, 0, 0, 0, 0, 10,
    0, 0, 0, 0, 0, 0, 0, 0, 0, 12,
    0, 0, 0, 0, 0, 0, 0, 0, 0, 15,
    0, 0, 0, 0, 0, 0, 0, 0, 0, 25
  ],

  "_comment_hp": "+11 HP за каждый уровень. К лв100 max_hp ≈ 60 + 99×11 = 1149.",
  "hp_on_reach": [
    0,
    11, 11, 11, 11, 11, 11, 11, 11, 11, 11,
    11, 11, 11, 11, 11, 11, 11, 11, 11, 11,
    11, 11, 11, 11, 11, 11, 11, 11, 11, 11,
    11, 11, 11, 11, 11, 11, 11, 11, 11, 11,
    11, 11, 11, 11, 11, 11, 11, 11, 11, 11,
    11, 11, 11, 11, 11, 11, 11, 11, 11, 11,
    11, 11, 11, 11, 11, 11, 11, 11, 11, 11,
    11, 11, 11, 11, 11, 11, 11, 11, 11, 11,
    11, 11, 11, 11, 11, 11, 11, 11, 11, 11,
    11, 11, 11, 11, 11, 11, 11, 11, 11, 11
  ],

  "_comment_steps": "Промежуточные +1 стат на полоске уровня. Больше шагов = чаще чувствуешь прогресс.",
  "steps_per_level": [
    2, 2, 2, 2, 2,
    3, 3, 3, 3, 3,
    4, 4, 4, 4, 4, 4, 4, 4, 4, 4,
    5, 5, 5, 5, 5, 5, 5, 5, 5, 5,
    5, 5, 5, 5, 5, 5, 5, 5, 5, 5,
    6, 6, 6, 6, 6, 6, 6, 6, 6, 6,
    6, 6, 6, 6, 6, 6, 6, 6, 6, 6,
    6, 6, 6, 6, 6, 6, 6, 6, 6, 6,
    7, 7, 7, 7, 7, 7, 7, 7, 7, 7,
    7, 7, 7, 7, 7, 7, 7, 7, 7, 7,
    8, 8, 8, 8, 8, 8, 8, 8, 8
  ]
}
